********e*
i000*0*00*
**0**0*0**
**0000000*
*0*0****0*
*0*0*0*00*
**00*0*0**
**0*0000**
****0*****
*00000000i
**********